||||||||||
|XX # #  |
|X   #   |
|XX # #  |
||||||| *|
||||||||||